*** Reading data from ./data/english_subs.vec
(1000000, 300)
1000000 words of dimension 300 : </s>, I, the, you, ..., kirai_na, Pinderhjuz, Cherry_Beach, Gimmes
1000000 words of dimension 300 : </s>, I, the, you, ..., kirai_na, Pinderhjuz, Cherry_Beach, Gimmes
Loaded attributes
Format:
word,
definitional female -1.0 -> definitional male 1.0
stereotypical female -1.0 -> stereotypical male 1.0
Minsk=Minskov-Belarus
Thimphu=Batdambang-Bhutan
Nicosia=Nicos-Cyprus
Brazil=Brazils-real
USA=United_States-dollar
Sacramento=Sacramento_Creek-California
Scottsdale=scottsdale-Arizona
Rome=Flavius_Aetius-Italy
Tallinn=Tallin-Estonia
Bulgaria=Bulgaria_Hungary-lev
Romania=Poland_Romania-leu
Detroit=Detroit_City-Michigan
Lubbock=lubbock-Texas
Lexington=lexington-Kentucky
Irving=Irvin-Texas
Riga=Rigac-Latvia
Taipei=Taipei_City-Taiwan
Latvia=latvia-lats
Bakersfield=bakersfield-California
Anchorage=anchorage-Alaska
Khartoum=khartoum-Sudan
Oslo=Stockholm-Norway
Cleveland=East_Cleveland-Ohio
Madison=Kadison-Wisconsin
Seattle=Seattles-Washington
Glendale=Allendale-Arizona
India=Indias-rupee
Harare=Harar-Zimbabwe
Sweden=Swedens-krona
boy=lad-girl
Warsaw=Warsawer-Poland
Bucharest=bucharest-Romania
Belgrade=Belgrad-Serbia
decided=Decided-undecided
Hanoi=bomb_Hanoi-Vietnam
policeman=apoliceman-policewoman
Tbilisi=Tbilissi-Georgia
Denver=Denvers-Colorado
Asmara=Asmar-Eritrea
brothers=KEG_brothers-sisters
Mesa=mesa-Arizona
Beijing=Beijinger-China
Chicago=Chicagos-Illinois
Tacoma=tacoma-Washington
Tallahassee=tallahassee-Florida
Beirut=East_Beirut-Lebanon
Kiev=Moscow_Leningrad-Ukraine
Astana=Mastana-Kazakhstan
his=His-her
grandfather=greatgrandfather-grandmother
Antananarivo=Antanas-Madagascar
Kigali=Kigali_Rwanda-Rwanda
Muscat=Muscatel-Oman
Niamey=Niam-Niger
competitive=uncompetitive-uncompetitive
Milwaukee=milwaukee-Wisconsin
Valletta=Valletti-Malta
Helsinki=helsinki-Finland
Skopje=Beykoz-Macedonia
Gaborone=Gabarone-Botswana
Glendale=Allendale-California
Minneapolis=minneapolis-Minnesota
comfortable=comfortableI-uncomfortable
Tashkent=Meshkent-Uzbekistan
Doha=Dohaku-Qatar
Maputo=maputo-Mozambique
Vientiane=Vien-Laos
Manila=Manilal-Philippines
Poland=Germany-zloty
Louisville=louisville-Kentucky
Nairobi=Nairobis-Kenya
Libreville=Breville-Gabon
Manama=Kanama-Bahrain
known=Known-unknown
Amarillo=Amarilla-Texas
Brussels=Brussel-Belgium
informative=Informative-uninformative
Houston=Houston_Rockets-Texas
Reno=Vegas-Nevada
Denmark=Denmar-krone
Japan=Japans-yen
acceptable=Acceptable-unacceptable
Toledo=ofToledo-Ohio
he=He-she
Lima=Tango_Lima-Peru
Iran=Tehran_Iran-rial
sons=grandsons-daughters
Cincinnati=Cincinnati_Kid-Ohio
Nassau=nassau-Bahamas
impressive=unimpressive-unimpressive
Nuuk=Owmwuk-Greenland
sure=surey-unsure
Islamabad=islamabad-Pakistan
Budapest=Budapesht-Hungary
Managua=managua-Nicaragua
Rabat=Ashgabat-Morocco
logical=Illogical-illogical
Nashville=East_Nashville-Tennessee
possibly=tpossibly-impossibly
Sofia=Sofias-Bulgaria
Bangkok=bangkok-Thailand
father=mYfather-mother
Hialeah=hialeah-Florida
Nigeria=Nigerian-naira
Caracas=Caraco-Venezuela
Chandler=Chandley-Arizona
Quito=Kuito-Ecuador
Orlando=Orlanda-Florida
Croatia=croatia-kuna
Modesto=modesto-California
likely=most_likely-unlikely
possible=ifpossible-impossible
king=King-queen
Zagreb=zagreb-Croatia
Boston=Philly-Massachusetts
brother=abrother-sister
fortunate=ortunate-unfortunate
informed=inform-uninformed
Baku=Bakush-Azerbaijan
Madrid=ofMadrid-Spain
Garland=Garlan-Texas
Monrovia=monrovia-Liberia
Armenia=Armenians-dram
Canada=Canaday-dollar
reasonable=Reasonable-unreasonable
Omaha=Omaha_Beach-Nebraska
consistent=Consistent-inconsistent
Ljubljana=ljubljana-Slovenia
Luanda=Juanda-Angola
Laredo=laredo-Texas
Oakland=East_Oakland-California
Tampa=Tampa_Florida-Florida
dad=Dad-mom
Memphis=Μemphis-Tennessee
Irvine=Irvin-California
Georgetown=georgetown-Guyana
Tucson=Tucsos-Arizona
Yerevan=Yerzhan-Armenia
Macedonia=Macedonio-denar
Worcester=worcester-Massachusetts
Akron=Akroy-Ohio
Tokyo=Tokyo_Yokohama-Japan
Tirana=Tiran-Albania
Huntsville=huntsville-Alabama
convenient=Convenient-inconvenient
grandson=Grandson-granddaughter
Hungary=Poland_Hungary-forint
husband=father-wife
Arlington=845_Arlington-Texas
Algeria=Algerian-dinar
Dhaka=haka-Bangladesh
man=dude-woman
Apia=Apias-Samoa
Havana=Havan-Cuba
Tegucigalpa=Matagalpa-Honduras
Russia=Russias-ruble
ethical=ethic-unethical
Austin=Jay_Austin-Texas
Tunis=Tunisia-Tunisia
Europe=Europes-euro
Copenhagen=Kopenhagen-Denmark
Baltimore=East_Baltimore-Maryland
clear=cleare-unclear
pleasant=pleasanter-unpleasant
Mexico=Juarez_Mexico-peso
Mogadishu=mogadishu-Somalia
Vietnam=Vietnams-dong
Henderson=Henders-Nevada
Pittsburgh=Pittsburg-Pennsylvania
rational=logical-irrational
groom=bridegroom-bride
Bujumbura=Chalawan-Burundi
Algiers=algiers-Algeria
responsible=responsibles-irresponsible
Bamako=Ôamako-Mali
Kampala=kampala-Uganda
honest=behonest-dishonest
Berlin=Berlin_Germany-Germany
Fontana=Fontan-California
Vienna=Viennas-Austria
Bratislava=1969_Bratislava-Slovakia
Lisbon=Lisbon_Portugal-Portugal
son=brother-daughter
Fresno=Fresnoy-California
Tulsa=Tulsaco-Oklahoma
Dublin=Dublino-Ireland
Windhoek=Windholm-Namibia
uncle=Uncle-aunt
Shreveport=shreveport-Louisiana
Dushanbe=Dushan-Tajikistan
Suva=Suvari-Fiji
nephew=grandnephew-niece
Damascus=damascus-Syria
Jacksonville=jacksonville-Florida
Wichita=Wichita_Falls-Kansas
Ashgabat=Ashgar-Turkmenistan
stepson=Stepson-stepdaughter
Santiago=Santiaguito-Chile
Philadelphia=Philadelphian-Pennsylvania
aware=awared-unaware
Athens=Athens_Greece-Greece
Tripoli=tripoli-Libya
Kingston=kingston-Jamaica
Korea=South_Korea-won
Ankara=Ankari-Turkey
Kathmandu=kathmandu-Nepal
certain=certainy-uncertain
Honolulu=honolulu-Hawaii
Oxnard=oxnard-California
Podgorica=Podgorny-Montenegro
Argentina=Argentina_Uruguay-peso
Thailand=thailand-baht
Canberra=canberra-Australia
efficient=Inefficient-inefficient
Stockton=stockton-California
convincing=Convincing-unconvincing
Indianapolis=indianapolis-Indiana
Chisinau=khasinau-Moldova
Lithuania=Fithuania-litas
Malaysia=malaysia-ringgit
Accra=Accross-Ghana
Anaheim=anaheim-California
Montevideo=Banco_Nacional-Uruguay
Vaduz=Eadu-Liechtenstein
Phoenix=Phoenixes-Arizona
Fremont=Tremont-California
productive=counter_productive-unproductive
Conakry=Mustappa-Guinea
Paris=London-France
Cairo=Cairo_Egypt-Egypt
Lusaka=Tosaka-Zambia
Vilnius=vilnius-Lithuania
Baghdad=Baghdadi-Iraq
Amman=Ammann-Jordan
Paramaribo=Parama-Suriname
Dakar=Al_Ansakar-Senegal
grandpa=Grandpa-grandma
Moscow=Moscow_Leningrad-Russia
Kabul=Kabul_Afghanistan-Afghanistan
Portland=Portlandia-Oregon
Abuja=Abu_al-Nigeria
Atlanta=Detroit_Atlanta-Georgia
Spokane=spokane-Washington
tasteful=Tasteful-distasteful
Tehran=Tehran_Iran-Iran
Dallas=Dallas_Dallas-Texas
prince=Prince-princess
Ottawa=ottawa-Canada
Stockholm=Stockholms-Sweden
Miami=Miamis-Florida
stepbrother=Stepbrother-stepsister
stepfather=stepfathers-stepmother
Bern=Berne-Switzerland
London=ofLondon-England
Plano=Serlano-Texas
Jakarta=jakarta-Indonesia
75
266
accuracy = 0.2819548872180451
definitional [['woman', 'man'], ['girl', 'boy'], ['she', 'he'], ['mother', 'father'], ['daughter', 'son'], ['gal', 'guy'], ['female', 'male'], ['her', 'his'], ['herself', 'himself'], ['Mary', 'John']]
gender specific 214 ['actress', 'actresses', 'aunt', 'aunts', 'bachelor', 'ballerina', 'barbershop', 'baritone', 'beard', 'beards']
1000000 words of dimension 300 : </s>, I, the, you, ..., kirai_na, Pinderhjuz, Cherry_Beach, Gimmes
{('CATHOLIC_PRIEST', 'NUN'), ('Boys', 'Girls'), ('BOY', 'GIRL'), ('Prince', 'Princess'), ('His', 'Her'), ('catholic_priest', 'nun'), ('GENTLEMEN', 'LADIES'), ('Dudes', 'Gals'), ('MAN', 'WOMAN'), ('Spokesman', 'Spokeswoman'), ('boy', 'girl'), ('businessman', 'businesswoman'), ('Grandpa', 'Grandma'), ('SPOKESMAN', 'SPOKESWOMAN'), ('Businessman', 'Businesswoman'), ('BROTHER', 'SISTER'), ('SON', 'DAUGHTER'), ('twin_brother', 'twin_sister'), ('NEPHEW', 'NIECE'), ('Brothers', 'Sisters'), ('brothers', 'sisters'), ('Prostate_Cancer', 'Ovarian_Cancer'), ('GRANDSONS', 'GRANDDAUGHTERS'), ('grandsons', 'granddaughters'), ('his', 'her'), ('grandfather', 'grandmother'), ('KING', 'QUEEN'), ('Dads', 'Moms'), ('King', 'Queen'), ('GRANDSON', 'GRANDDAUGHTER'), ('Dad', 'Mom'), ('Ex_Girlfriend', 'Ex_Boyfriend'), ('BUSINESSMAN', 'BUSINESSWOMAN'), ('Himself', 'Herself'), ('Kings', 'Queens'), ('COUNCILMAN', 'COUNCILWOMAN'), ('monastery', 'convent'), ('Men', 'Women'), ('himself', 'herself'), ('WIVES', 'HUSBANDS'), ('Son', 'Daughter'), ('men', 'women'), ('Grandfather', 'Grandmother'), ('boys', 'girls'), ('Fathers', 'Mothers'), ('chairman', 'chairwoman'), ('HIMSELF', 'HERSELF'), ('DAD', 'MOM'), ('schoolboy', 'schoolgirl'), ('BOYS', 'GIRLS'), ('GRANDFATHER', 'GRANDMOTHER'), ('TWIN_BROTHER', 'TWIN_SISTER'), ('kings', 'queens'), ('males', 'females'), ('he', 'she'), ('dads', 'moms'), ('sons', 'daughters'), ('Fatherhood', 'Motherhood'), ('FELLA', 'GRANNY'), ('Fella', 'Granny'), ('Schoolboy', 'Schoolgirl'), ('Councilman', 'Councilwoman'), ('He', 'She'), ('SCHOOLBOY', 'SCHOOLGIRL'), ('father', 'mother'), ('dudes', 'gals'), ('EX_GIRLFRIEND', 'EX_BOYFRIEND'), ('king', 'queen'), ('wives', 'husbands'), ('Grandson', 'Granddaughter'), ('FRATERNITY', 'SORORITY'), ('dad', 'mom'), ('UNCLE', 'AUNT'), ('Brother', 'Sister'), ('gentleman', 'lady'), ('fraternity', 'sorority'), ('COLT', 'FILLY'), ('HE', 'SHE'), ('Gentleman', 'Lady'), ('Uncle', 'Aunt'), ('grandson', 'granddaughter'), ('BROTHERS', 'SISTERS'), ('man', 'woman'), ('FATHERHOOD', 'MOTHERHOOD'), ('prostate_cancer', 'ovarian_cancer'), ('PRINCE', 'PRINCESS'), ('FATHERS', 'MOTHERS'), ('CHAIRMAN', 'CHAIRWOMAN'), ('Twin_Brother', 'Twin_Sister'), ('spokesman', 'spokeswoman'), ('Catholic_Priest', 'Nun'), ('Chairman', 'Chairwoman'), ('Monastery', 'Convent'), ('fatherhood', 'motherhood'), ('MALES', 'FEMALES'), ('son', 'daughter'), ('DADS', 'MOMS'), ('Nephew', 'Niece'), ('SONS', 'DAUGHTERS'), ('uncle', 'aunt'), ('nephew', 'niece'), ('testosterone', 'estrogen'), ('MALE', 'FEMALE'), ('Grandsons', 'Granddaughters'), ('ex_girlfriend', 'ex_boyfriend'), ('Fraternity', 'Sorority'), ('HIS', 'HER'), ('Boy', 'Girl'), ('fella', 'granny'), ('GRANDPA', 'GRANDMA'), ('KINGS', 'QUEENS'), ('Father', 'Mother'), ('Male', 'Female'), ('colt', 'filly'), ('GENTLEMAN', 'LADY'), ('male', 'female'), ('FATHER', 'MOTHER'), ('MONASTERY', 'CONVENT'), ('Gentlemen', 'Ladies'), ('PROSTATE_CANCER', 'OVARIAN_CANCER'), ('Males', 'Females'), ('grandpa', 'grandma'), ('fathers', 'mothers'), ('Wives', 'Husbands'), ('gentlemen', 'ladies'), ('Testosterone', 'Estrogen'), ('prince', 'princess'), ('Colt', 'Filly'), ('MEN', 'WOMEN'), ('DUDES', 'GALS'), ('TESTOSTERONE', 'ESTROGEN'), ('Man', 'Woman'), ('Sons', 'Daughters'), ('brother', 'sister'), ('councilman', 'councilwoman')}
1000000 words of dimension 300 : </s>, I, the, you, ..., kirai_na, Pinderhjuz, Cherry_Beach, Gimmes
ambitious=overambitious-aggressive
tender=tenderly-caring
gentle=gentle_gentle-assertive
graceful=Graceful-independent
dominant=dominant_ego-strong
brave=courageous-warm
compassionate=Compassionate-emotional
competitive=uncompetitive-empathetic
2
8
accuracy = 0.25